NO ./path/to/north_texture.xpm
	SO			./path/to/south_texture.xpm
WE ./path/to/west_texture.xpm     	
EA	  	   	./path/to/east_texture.xpm

F	240,200,1
C     	222,222,222

		11
	11111111
11111000001111
111110000001111
111110000001111
111110000001111
111110000000001111
1111100000000111111111111111111111111111111111111
111110000000000000000000000000000000000000000001111
11111000001111111111111111111111111111111111111
11111000001111
11111000001111
11111000001111
11111000001111
11111000001111
11111000001111
11111000001111
11111000001111
11111000001111
11111000001111
11111000001111
11111000001111
11111000001111
11111000001111
11111000001111
11111000001111
11111000001111
11111000001111
11111000001111
11111000001111
11111000001111
11111000001111
11111000001111
	1N0001
	111111
