NO ./path/to/north_texture.xpm
	SO			./path/to/south_texture.xpm
WE ./path/to/west_texture.xpm     	



F 240,200,1

C	222,222,222

11111111
 10001
11N0001
111111
