 NO ./path/to/north_texture.xpm
 	SO			./path/to/south_texture.xpm
WE ./path/to/west_texture.xpm     	
EA	  	   	./path/to/east_texture.xpm
 F	240,200,1
C     	222,222,222

		11
	11111111
11111000W01111
	1N0001
	111111
